111111111111111111111
1P001100C110C1100C111
1011C10011000C1100011
1000000000000000000E1
111111111111111111111